111111111111111111111
100010100010000010101
101010111011111010101
101010001000001000001
111010101010101011101
100010100010101010001
111010101010111010111
100000101010000010101
101010101111101010101
101010100010101010101
101011101010101011101
101000101010101010001
101010101110101011101
101010101000001000101
111110101110111010101
101010101000001010101
101011101010101011101
101000101010101010101
101110111010101110101
100000000010100000001
111111111111111111111
