1111111111111
1000001000101
1011111011101
1010100000001
1010111111101
1000100010001
1010111011101
1010100000001
1010101111111
1010001010101
1010101010101
1010100000001
1111111111111
